Kelly - 캘리 - 보통성격 여자아이한테 어울리고, 여전사라는 뜻입니다.

Sally - 샐리 - 귀여운 아이에게 어울립니다.

Rachel - 레이첼 - 이쁘장하게 생긴 여자아이에게 어울립니다.

Whitney - 위트니 - 날라리(?)성격을 가진 여자아이에게 잘 어울립니다.

Sunny - 써니 - 좀 마르고 키는 보통이고 좀 범생이인 아이에게 잘 어울립니다.

Melissa - 멜리사 - 매력이 철철 넘치는 아이에게 잘 어울립니다.

Rebecca - 레베카 - 키가 큰 아이에게 잘 어울립니다.

Nikita - 니키타 - 알것 같으면서도 모르는 여자아이.

Emily - 에밀리 - 조금 내숭떠는 여자아이. 여성스럽다는 뜻.

Anna - 애나 - 보통 성격을 가진 여자아이.

Mikhaila - 미케일라 - 이 이름 역시 이쁘장한 여자아이에게 잘 어울립니다.

Victoria - 빅토리아 - 정말로 이쁜 여자아이.

Angela - 안젤라 - 보통아이.

Katrina - 카트리나 - 공부를 잘하는 여자아이에게 어울립니다.

Jasmin - 자스민 - 상냥한 여자라는 뜻을 지니고 있습니다.

Esther - 에스더 - 모범생이고 머리가 긴 여자아이에게 어울리죠!

Michelle - 미셸 - 프랑스이름으로 활발한 여자아이에게 잘 어울립니다.

Dana - 다나, 데이너 - 귀엽고 깜찍한 아이, 총명하고 순결한사람.

Julia - 줄리아 - 부드러운 머리결, 총 3.6%의 미국인이 이용하는 대중이름 입니다.

Juana - 쥬아나 - 신의 이득.

Yeriel - 예리엘 - 신에 의해서 찾아진 이라는 뜻입니다.

Yesica - 예시카 - 부유라는 뜻.

Erica - 에리카 - 꽃 이름, 여왕 또는 왕비=queen과 같음, 권력 있는, 통치자, 제왕.

(. 님이랑 다른뜻도 있어서 올렸습니다.)

Raye - 레이 - Rachel 레이첼을 줄인 이름(Rachel의 애칭).

hilda - 힐다 - 여자병사에서 나온 말.

Marcia - 마샤 - 전쟁의 여신.

Martina - 마티나 - 전쟁의 여신.

Avril - 에이브릴 - 유명한 팝스타의 이름이자 프랑스어로 4월을 뜻한다.

Zoe - 조이 - 생명, 인생, 목숨만큼 소중한 사람.

Chloe - 클로이 - 젊은, 활짝 꽃핀, 만발한, 꽃같은, 꽃다운 등.

Stella - 스텔라 - 별, 행운, 성공이란 뜻을 가지고 있습니다.

Catherine - 캐더린 - 깨끗하고 순수하다.

Ophelia - 오필리아-도움이 되는 사람, 협력자, 지지자.

Iris - 아이리스 - 붓꽃, 무지개의 여신.

Daisy - 데이지 - 데이지꽃. 이름으로 쓰이기도 한다.

Amber - 앰버 - 화려한 보석.

Ashley - 아실리 - 꿈, vision.

Amanda - 아맨다 - 사랑 받을 가치 있는.

 

Ann - 앤 - 은혜.

Andrea - 앤드리 - 여성다운,여성스러운.

Vivian - 비비안 - 활달한이라는 의미에서 유래된 이름으로 'vi'는 '생명'을 뜻합니다.

Bonnie - 바니, 버니, 보니 - 예쁘장한, 사랑스러운, 기분 좋은, 예쁜 소녀.

Madalyn - 마다린 - 위대하고 숭고한.

Monica - 모니카 - 고귀, 유일한, 고문.

Amanda - 아맨다 - 사랑스러운.

Alyssa - 앨리사 - 존귀하다,착실하다.

Agatha - 애가사 - 선량하고,아름다운.

Beth - 베쓰 - 신의 서약.

Caroline - 캐롤라인 - 용감,건강하다.

Christine - 크리스틴 - 그리스도의 신도,추종자.

Diana - 다이애너 - 흰색처럼 환하다,달의 여신.

Dorothy - 도러시 - 신의 선물.

Frances - 프랜시스 - 자유로운 사람.

Gloria - 글로리아 - 영광을 주는 사람.

Hannah - 해나 - 우아한.

Heather - 헤더 - 히스꽃.

Isabel - 이자벨 - 하느님의 서약.

Joanna - 죠애나 - 신의 선물.

Jennifer - 제니퍼 - 흰 파도, 마술요법, 요정, 매혹적인 여자.

Jennet - 제넷 - 소녀,신의 은총.

Laura - 로라 - 월계수,승리.

Lesley - 레즐리 - 옛 보루에서 온것.

Margaret - 마가렛 - 진주.

Miriam - 미리엄 - 슬프다, 고통의 바다.

Natalie(Natalia) - 내털리 - 성탄절에 태어난 사람.

Nicole - 니콜 - 승리자.

Rebecca - 레베카 - 함정, 매력적인 아름다움.

Sabrina - 사브리나 - 변경에서 온 사람.

Sara(Sarah) - 사라 - 공주.

Sharon - 샤론 - 매우 아름다운 공주